
# ============================================================================
# DeCS Finder Servlet
# ============================================================================

Main Content|Main content|Contenido principal|Conteúdo principal|Contenu principal
Menu|Menu|Menú|Menu|Menu
Search|Search|Búsqueda|Pesquisa|Recherche
Footer|Footer|Pie de página|Rodapé|Bas de page
High Contrast|High contrast|Alto contraste|Alto contraste|Contraste élevé
Accessibility|Accessibility|Accesibilidad|Acessibilidade|Accessibilité
Disclaimer|Warning: This service uses a computer program to identify and suggest DeCS/MeSH terms based on the words entered in the text. The identified/suggested terms do not reflect automatic indexing and should not be used indiscriminately, as they do not replace the reading and analysis process of a professional indexer.|Aviso: Este servicio utiliza un programa de computadora para identificar y sugerir términos DeCS/MeSH a partir de las palabras ingresadas en el texto. Los términos identificados/sugeridos no reflejan una indexación automática y no deben ser utilizados indiscriminadamente, ya que no sustituyen el proceso de lectura y análisis del profesional indexador.|Aviso: Este serviço utiliza um programa de computador para identificar e sugerir termos DeCS/MeSH a partir de palavras do texto entrado. Os termos identificados/sugeridos não refletem uma indexação automática e não devem ser utilizados indiscriminadamente, pois não substituem o processo de leitura e análise do profissional indexador.|Avertissement : Ce service utilise un programme informatique pour identifier et suggérer des termes DeCS/MeSH à partir des mots saisis dans le texte. Les termes identifiés/suggérés ne reflètent pas une indexation automatique et ne doivent pas être utilisés de manière indiscriminée, car ils ne remplacent pas le processus de lecture et d'analyse par un professionnel de l'indexation.
Language of your text|Language of your text|Idioma de su texto|Idioma do seu texto|Langue de votre texte
Language of the terms|Language of the terms|Idioma de los término|Idioma dos termos|Langue des termes
Types of terms|Types of terms|Tipos de términos|Tipos de termos|Types de termes
I don't know|I don't know|No lo sé|Eu não sei|Je ne sais pas
English|English|Inglés|Inglês|Anglais
Spanish|Spanish|Español|Espanhol|Espagnol
Portuguese|Portuguese|Portugués|Português|Portugais
French|French|Francés|Francês|Français
The same found in the text|The same found in the text|Lo mismo encontrado en el texto|O mesmo localizado no texto|Le même trouvé dans le texte
Descriptors|Descriptors|Descriptores|Descritores|Descripteurs
Qualifiers|Qualifiers|Calificadores|Qualificadores|Qualificatifs
Entry terms|Entry terms|Términos alternativos|Termos alternativos|Termes alternatifs
Publication types|Publication types|Tipos de publicación|Tipos de publicação|Types de publication
Check tags|Check tags|Precodificados|Pré-codificados|Précodifié
Geographics|Geographics|Denominaciones geográficas|Denominações geográficas|Lieux géographiques
Your text|Your text|Tu texto|Seu texto|Ton texte
Extracted descriptors|Extracted terms|Términos extraídos|Termos extraídos|Termes extraits
Terms identified by AI|Terms identified by AI|Términos identificados por IA|Termos identificados por IA|Termes identifiés par IA
Import file|Import file|Importar archivo|Importar arquivo|Importer le fichier
Search|Search|Buscar|Procurar|Chercher
Clear|Clear|Limpiar|Limpar|Nettoyer
SR|SS|SR|SR|SR
SuperAbstract|Super summaries|Súper resúmenes|Super resumos|Super résumés
Numerical order|Numerical order|Orden numérica|Ordem numérica|Ordre numérique
Alphabetical order|Alphabetical order|Orden alfabética|Ordem alfabética|Ordre alphabétique
Export to file|Export to file|Exportar a archivo|Exportar para arquivo|Exporter vers un fichier
Send your comments|Send your comments|Envíe sus comentarios|Envie seus comentários|Envoyez vos commentaires
Sorry|Sorry, your input text must be between 300 and 2300 characters long for a super summary to be generated.|Lo siento, el texto ingresado debe tener entre 300 y 2300 caracteres para que se genere un superresumen.|Desculpe, o texto inserido deve ter entre 300 e 2300 caracteres para que um super resumo seja gerado.|Désolé, le texte saisi doit contenir entre 300 et 2300 caractères pour qu’un super résumé soit généré.
Warning|Warning|Advertencia|Aviso|Avertissement
Notice|Notice: This service uses Annif, an artificial intelligence software, to assist in identifying DeCS/MeSH descriptors from a text. The suggested terms must be reviewed by a professional and do not replace human reading and analysis in the indexing process.|Aviso: Este servicio utiliza Annif, un software de inteligencia artificial, para apoyar la identificación de descriptores DeCS/MeSH a partir de un texto. Los términos sugeridos deben ser revisados por un profesional y no sustituyen la lectura y el análisis humano en el proceso de indexación.|Aviso: Este serviço utiliza Annif, um software de inteligência artificial, para apoiar a identificação de descritores DeCS/MeSH a partir de um texto. Os termos sugeridos devem ser revisados por um profissional, não substituindo a leitura e análise humana no processo de indexação.|Avertissement : Ce service utilise Annif, un logiciel d'intelligence artificielle, pour soutenir l'identification des descripteurs DeCS/MeSH à partir d'un texte. Les termes suggérés doivent être révisés par un professionnel et ne remplacent pas la lecture et l'analyse humaines dans le processus d'indexation.
Terms and conditions of use|Terms and Conditions of Use|Términos y Condiciones de Uso|Termos e Condições de Uso|Termes et Conditions d'utilisation
Privacy policy|Privacy Policy|Política de Privacidad|Política de Privacidade|Politique de Confidentialité

# ============================================================================
# DeCS Finder Wizzard Servlet
# ============================================================================

Choose one of the options below to identify the DeCS/MeSH terms in your text|Choose one of the options below to identify the DeCS/MeSH terms in your text|Elija una de las opciones siguientes para identificar los términos DeCS/MeSH en su texto|Escolha uma das opções abaixo para identificar os termos DeCS/MeSH em seu texto|Choisissez l'une des options ci-dessous pour identifier les termes DeCS/MeSH dans votre texte
SIMPLE|Beginner users|Usuarios principiantes|Usuários iniciantes|Utilisateurs débutants
ADVANCED|Advanced users|Usuarios avanzados|Usuários avançados|Utilisateurs avancés
Answer the following questions|Answer the following questions|Responda las siguientes preguntas|Responda às seguintes perguntas|Répondez aux questions suivantes
What is the language of your text|What is the language of your text|¿Cuál es el idioma de tu texto|Qual é o idioma do seu texto|Quelle est la langue de votre texte
Select|Select|Seleccione|Selecione|Sélectionnez l'une des options
Paste your text below|Paste your text below|Pega tu texto a continuación|Cole abaixo o seu texto|Collez votre texte ci-dessous
Next|Next|Próximo|Próximo|Prochain
In what language do you want to see the DeCS/MeSH terms|In what language do you want to see the DeCS/MeSH terms|¿En qué idioma desea ver los términos DeCS/MeSH|Em qual idioma deseja ver os termos do DeCS/MeSH|Dans quelle langue voulez-vous voir les termes DeCS/MeSH
Do you want to use advanced filters|Do you want to use advanced filters|¿Quieres utilizar filtros avanzados|Você quer usar filtros avançados|Voulez-vous utiliser des filtres avancés
No, proceed with the identification of DeCS/MeSH terms|No, proceed with the identification of DeCS/MeSH terms|No, proceda con la identificación de los términos DeCS/MeSH|Não, prossiga com a identificação dos termos do DeCS/MeSH|Non, procédez à l'identification des termes DeCS/MeSH
Yes, go to them|Yes, go to them|Sí, ve a ellas|Sim, vá até eles|Oui, allez vers eux
Which types of terms do you want to identify|Which types of terms do you want to identify|¿Qué tipo de términos quieres identificar|Quais tipos de termos você deseja identificar|Quels types de termes voulez-vous identifier

# ============================================================================
# DeCS Finder Site Servlet
# ============================================================================

Automatically find all DeCS/MeSH terms in your document|Automatically find all DeCS/MeSH terms in your document|Encuentre automáticamente todos los términos DeCS/MeSH en su documento|Localize automaticamente todos os termos DeCS/MeSH presentes em seu documento|Rechercher automatiquement tous les termes DeCS/MeSH dans votre document
Try it now|Try it now|Pruebalo ahora|Tente agora|Essayez-le maintenant
How to use|How to use|Cómo utilizar|Como usar|Comment l'utiliser
Select your Text|Select your text|Seleccione su texto|Selecione o seu texto|Sélectionnez votre texte
Select the text in which you want to find the DeCS/MeSH terms|Select the text in which you want to find the DeCS/MeSH terms|Seleccione el texto en el que desea encontrar los términos DeCS/MeSH|Selecione o texto no qual deseja localizar os termos DeCS/MeSH|Sélectionnez le texte dans lequel vous souhaitez trouver les termes DeCS/MeSH
Paste your Text|Paste your text|Pega tu texto|Cole o seu texto|Collez votre texte
Enter the selected text on the application page|Enter the selected text on the application page|Ingrese el texto seleccionado en la página de la aplicación|Entre com o texto selecionado na página da aplicação|Entrez le texte sélectionné sur la page de l'application
View your result|View your result|Ver su resultado|Veja o seu resultado|Afficher votre résultat
Get the list of localized DeCS/MeSH terms instantly|Get the list of localized DeCS/MeSH terms instantly|Obtenga la lista de términos localizados DeCS/MeSH al instante|Obtenha instantaneamente a lista de termos DeCS/MeSH localizados|Obtenez instantanément la liste des termes DeCS/MeSH localisés
Why use DeCS Finder|Why use DeCS Finder|Por qué utilizar DeCS Finder|Por que usar o DeCS Finder|Pourquoi utiliser le DeCS Finder
Determining the keywords|Determining the keywords that briefly describe your text is often a laborious task. The use of terms belonging to the controlled DeCS/MeSH vocabulary provides an accurate and professional way of describing a text in the health field. The DeCS Finder is an application that locates, in a simple and automatic way, DeCS/MeSH terms contained in an electronic text, assisting in the task of determining the keywords that can describe your text. With its simple and advanced interfaces, it allows its use by people without any experience, as well as by professionals in the area of document indexing.|Determinar las palabras clave que describen brevemente su texto suele ser una tarea laboriosa. El uso de términos pertenecientes al vocabulario controlado DeCS/MeSH proporciona una forma precisa y profesional de describir un texto en el campo de la salud. El resaltador DeCS/MeSH es una aplicación que localiza, de forma sencilla y automática, términos DeCS/MeSH contenidos en un texto electrónico, ayudando en la tarea de determinar las palabras clave que pueden describir su texto. Con sus interfaces simples y avanzadas, permite su uso por personas sin experiencia, así como por profesionales en el área de indexación de documentos.|Determinar as palavras-chave que descrevam de maneira resumida o seu texto costuma ser uma tarefa trabalhosa. O uso de termos pertencentes ao vocabuário controlado DeCS/MeSH proporciona uma maneira precisa e profissional de descrever um texto na área da saúde. O DeCS Finder é uma aplicação que localiza, de maneira simples e automática, termos DeCS/MeSH contidos em um texto eletrônico, auxiliando na tarefa de determinação das palavras-chave que podem descrever seu texto. Com suas interfaces simples e avançada, permite seu uso por pessoas sem nenhuma experiência, assim como por profissionais na área de indexação de documentos.|Trouver les mots-clés qui décrivent brièvement votre texte est souvent une tâche laborieuse. L'utilisation de termes appartenant au vocabulaire contrôlé DeCS/MeSH fournit une manière précise et professionnelle de décrire un texte dans le domaine de la santé. Le surligneur DeCS/MeSH est une application qui localise, simple et automatiquement, les termes DeCS/MeSH contenus dans un texte électronique, vous aidant à déterminer les mots-clés qui peuvent décrire votre texte. Avec ses interfaces simples et avancées, il permet son utilisation par des personnes sans aucune expérience, ainsi que par des professionnels dans le domaine de l'indexation de documents.
Technical Features|Technical Features|Características técnicas|Características técnicas|Caractéristiques techniques
The basic DeCS Finder interface|The basic DeCS Finder interface, using a step-by-step help mechanism, guides the novice user in a simple way in the process of finding DeCS/MeSH terms from the input text, regardless of the type of term found, that is, whether it is a descriptor, qualifier, synonym, etc.|La interfaz básica del resaltador DeCS/MeSH, que utiliza un mecanismo de ayuda paso a paso, guía al usuario novato de una manera sencilla en el proceso de búsqueda de términos DeCS/MeSH en el texto de entrada, independientemente del tipo de término encontrado, es decir, si es un descriptor, calificador, sinónimo, etc.|A interface básica do DeCS Finder, por meio de um mecanismo de ajuda passo-a-passo, guia o usuário iniciante de maneira simples no processo de localização de termos DeCS/MeSH do texto de entrada, independentemente do tipo de termo encontrado, isto é, se é um descritor, qualificador, sinônimo, etc.|L'interface de base du surligneur DeCS/MeSH, utilisant un mécanisme d'aide étape par étape, guide l'utilisateur novice de manière simple dans le processus de recherche des termes DeCS/MeSH à partir du texte d'entrée, quel que soit le type de terme trouvé, c'est-à-dire, s'il s'agit d'un descripteur, d'un qualificatif,  ou d'un synonyme, etc.
The advanced interface of DeCS Finder|The advanced interface of DeCS Finder is intended for users who feel more comfortable with the types of terms present in the DeCS/MeSH vocabulary, allowing all the control and agility in the process of finding the terms in the input text in a single interface.|La interfaz avanzada de DeCS Finder está dirigida a usuarios que se sienten más cómodos con los tipos de términos presentes en el vocabulario DeCS/MeSH, permitiendo todo el control y agilidad en el proceso de encontrar los términos en el texto de entrada en un solo interfaz.|A interface avançada do DeCS Finder é destinada aos usuários que se sentem mais confortáveis com os tipos de termos presentes no vocabulário DeCS/MeSH, permitindo ao mesmo todo o controle e agilidade no processo de localização dos termos no texto de entrada em uma única interface.|L'interface avancée du DeCS Finder est destinée aux utilisateurs qui se sentent plus à l'aise avec les types de termes présents dans le vocabulaire DeCS/MeSH, permettant tout le contrôle et l'agilité dans le processus de recherche des termes dans le texte d'entrée en un seul interface.
How does DeCS Finder find terms|How does DeCS Finder find terms|¿Cómo DeCS Finder encuentra los términos|Como o DeCS Finder localiza os termos|Comment le DeCS Finder trouve-t-il les termes
DeCS Finder goes through each word|DeCS Finder goes through each word of the text to be analyzed looking for terms from the thesaurus DeCS/MeSH. Once you have found a term, it analyzes whether it belongs to the types of desired terms previously selected by the user. If it does, add the term found in the term output list.|DeCS Finder recorre cada palabra del texto que se analizará en busca de términos del tesauro DeCS/MeSH. Una vez que ha encontrado un término, analiza si pertenece a los tipos de términos deseados previamente seleccionados por el usuario. Si es así, agregue el término que se encuentra en la lista de salida de términos.|O DeCS Finder percorre cada palavra do texto a ser analizado procurando por termos do thesauro DeCS/MeSH. Uma vez que tenha encontrado algum termo, analisa se o mesmo pertence aos tipos de termos desejados previamente seleciondos pelo usuário. Caso pertença, adiciona o termo encontrado na lista de saída de termos.|DeCS Finder parcourt chaque mot du texte à analyser à la recherche des termes du thésaurus DeCS/MeSH. Une fois que vous avez trouvé un terme, il analyse s'il appartient aux types de termes souhaités préalablement sélectionnés par l'utilisateur. Si c'est le cas, ajoutez le terme trouvé dans la liste de sortie des termes.
Is DeCS Finder free to use|Is DeCS Finder free to use|¿Es DeCS Finder de uso gratuito|O DeCS Finder é de uso gratuito|Est-il l'utilisation du DeCS Finder gratuite
Yes, using DeCS Finder is free|Yes, the use of DeCS Finder is free. You can use it as many times as you like without having to pay anything for it.|Sí, el uso de DeCS Finder es gratuito. Puedes usarlo tantas veces como quieras sin tener que pagar nada por él.|Sim, o uso do DeCS Finder é gratuito. Você pode utilizá-lo quantas vezes desejar sem ter que pagar nada por isso.|Oui, l'utilisation de DeCS Finder est gratuite. Vous pouvez l'utiliser autant de fois que vous le souhaitez sans avoir à payer quoi que ce soit.
Who are the main users of DeCS Finder|Who are the main users of DeCS Finder|¿Quiénes son los principales usuarios de DeCS Finder|Quais são os principais usuários do DeCS Finder|Qui sont les principaux utilisateurs de DeCS Finder
Three typical users of the tool are|Three typical users of the tool are: the author of bibliographic articles who, in the process of requesting publication, are required to provide keywords that describe the content of their article. The other typical user is the editor of scientific journals who, upon receiving an article publication request, uses the tool as an aid in the process of checking the relevance of the keywords provided for the description of the article's content. Librarians can also use it as an aid in the indexing process.|Tres usuarios típicos de la herramienta son: el autor de artículos bibliográficos que, en el proceso de solicitud de publicación, deben proporcionar palabras clave que describan el contenido de su artículo. El otro usuario típico es el editor editor de revistas científicas que, al recibir una solicitud de publicación de un artículo, utiliza la herramienta como ayuda en el proceso de verificación de la relevancia de las palabras clave proporcionadas para la descripción del contenido del artículo. Los bibliotecarios también pueden utilizarlo como ayuda en el proceso de indexación.|Três usuários típicos da ferramenta são: o autor de artigos bibliográfico que no processo de solicitação de publicação é requerido fornecer palavras-chave que descrevam o conteúdo de seu artigo. O outro usuário típico é o editor revisor de periódicos científicos que, ao receber uma solicitação de publicação de artigo, utiliza a ferramenta como auxiliar no processo de checagem da relevância das palavras-chaves fornecidas para a descrição do conteúdo do artigo. Bibliotecários também podem utilizar como auxiliar no processo de indexação.|Trois utilisateurs typiques de l'outil sont: l'auteur d'articles bibliographiques qui, dans le processus de demande de publication, sont tenus de fournir des mots-clés décrivant le contenu de leur article. Un autre utilisateur typique c'est l'éditeur de revues scientifiques qui, à la réception d'une demande de publication d'article, utilise l'outil comme aide dans le processus de vérification de la pertinence des mots-clés fournis pour la description du contenu de l'article. Les bibliothécaires peuvent également l'utiliser comme une aide dans le processus d'indexation.
How often is the DeCS/MeSH thesaurus updated|How often is the DeCS/MeSH thesaurus updated|¿Con qué frecuencia se actualiza el tesauro DeCS/MeSH|Com que frequência o tesauro DeCS/MeSH é atualizado|À quelle fréquence le thésaurus DeCS/MeSH est-il mis à jour
The DeCS/MeSH thesaurus is updated once a year, and it is released at the beginning of each year.|The DeCS/MeSH thesaurus is updated once a year, and it is released at the beginning of each year.|El tesauro DeCS/MeSH se actualiza una vez al año y se publica al comienzo de cada año.|O thesauro DeCS/MeSH é atualizado uma vez ao ano, sendo que sua liberação é feita logo no ínicio de cada ano.|Le thésaurus DeCS/MeSH est mis à jour une fois par an et est publié au début de chaque année.
How do I find the DeCS/MeSH terms on my web pages|How do I find the DeCS/MeSH terms on my web pages|¿Cómo encuentro los términos DeCS/MeSH en mis páginas web|Como encontrar os termos DeCS/MeSH nas minhas páginas web|Comment trouver les termes DeCS/MeSH sur mes pages web
Your web pages|Your web pages can have their DeCS/MeSH terms found through a web service associated with the DeCS Finder that performs term find processing in batches of documents. To learn more contact us at:|Sus páginas web pueden tener sus términos DeCS/MeSH encontrados a través de un servicio web asociado con DeCS Finder que realiza el procesamiento de búsqueda de términos en lotes de documentos. Para obtener más información contáctenos en:|Suas páginas da web podem ter seus termos DeCS/MeSH localizados por meio de um serviço web associado ao DeCS Finder que executa o processamento de localização de termos em lotes de documentos. Para saber mais contacte-nos em:|Les termes DeCS/MeSH de vos pages web peuvent être trouvés via un service web associé au DeCS Finder qui effectue le traitement de recherche de termes par lots de documents. Pour en savoir plus, contactez-nous à:
DeCS Finder Online Service|DeCS Finder Online Service|Servicio en línea DeCS Finder|Serviço online DeCS Finder|Service en ligne de DeCS Finder
How do I find DeCS/MeSH terms in many documents|How do I find DeCS/MeSH terms in many documents|¿Cómo encuentro términos DeCS/MeSH en muchos documentos|Como fazer a localização de termos DeCS/MeSH em muitos documentos|Comment trouver les termes DeCS/MeSH dans de nombreux documents
Your documents may have the terms DeCS/MeSH found|Your documents can have their DeCS/MeSH terms found through a web service associated with the DeCS Finder that performs term find processing in batches of documents. To learn more contact us at:|Sus documentos pueden tener sus términos DeCS/MeSH encontrados a través de un servicio web asociado con DeCS Finder que realiza el procesamiento de búsqueda de términos en lotes de documentos. Para obtener más información contáctenos en:|Seus documentos podem ter seus termos DeCS/MeSH encontrados por meio de um serviço web associado ao DeCS Finder que realiza o processamento de localização de termos em lotes de documentos. Para saber mais contacte-nos em:|Vos documents peuvent voir leurs termes DeCS/MeSH trouvés via un service web associé au DeCS Finder qui effectue le traitement de recherche de termes par lots de documents. Pour en savoir plus, contactez-nous à:
Access the DeCS/MeSH website|Access the DeCS/MeSH website|Acceda al sitio web DeCS/MeSH|Acesse o site DeCS/MeSH|Accédez au site Web DeCS/MeSH
